22-7
@.T...TTTT.......O...
.......TTT....T......
.T.....T.........S...
SSS.T.....T...T.S....
SSS....T....T........
SSS....TTT...........
.....................